BBBBBBBBBBBBBBBBBBBBBBBBBBBBBBBBBBBBBBBB
B                             BBBBBBBBBB
B                             BBBBBBBBBB
B                             BBBBBBBBBB
B      BBBBBBBBB                       B
B      BBBBBBBBB                       B
B          BBBBBBBBB                   B
B          BBBBBBBBB                   B
B                                      B
B                                      B
B                                      B
B                                      B
B                                      B
B                           BBBBBBBBBBBB
B                                      B
B                                      B
B                                      B
B                                      B
BBBBBBBBBBB        P                   B
B                                      B
B                                      B
BBBBBBBBBBBBBBBBBBBBBBBBBBBBBBBBBBBBBBBB